%%%%%%%%%%%%%%%%%%%%%%%%%%%%%%%%%%%%%%%%%%%%%%%
%.............................................%
%.%%%%%%%%%.%%%.%%%.%%%%%%%%%%%%%%.%%%%%%%%%%.%
%.%       %.% %.% %.%            %.%        %.%
%.%%%%%%%%%.% %.% %.%%%%%%%%%%%%%%.%%%%%%%%%%.%
%...........% %.% %...........................%
%.%%%%%%%%%.% %.% %%%%%%%.%%%%%%%%%.%%%%%%%%%.%
%.%       %.% %.%       %.%       %.%       %.%
%.%%%%%%% %.% %.% %%%%%%%.% %%%%% %.% %%%%% %.%
%.......% %.% %.% %.......% %   % %.% %...% %.%
%.%%%%%%% %.% %.% %.G.%%%.% %%%%% %.% %.%.% %.%
%.%       %.% %.% %.G.% %.%       %.% %.%.% %.%
%.% %%%%% %.% %.% %.G.% %.% %%%%%%%.% %.%.% %.%
%.% %   % %.% %.% %...% %.% %.......% %.%.% %.%
%.% %%%%% %.% %.% %%%%% %.% %%%%%%%.% %.%.% %.%
%.%       %.% %.%       %.%       %.% %.%.% %.%
%.%%%%%%%%%.%%%.%%%%%%%%%.%%%%%%%%%.%%%.%.%%%.%
%......................P......................%
%.%%%%.%%%%%%%%%%%%%%.%%%%.%%%%%%%%%%%%%.%%%%.%
%.%  %.%            %.%  %.%           %.%  %.%
%.%%%%.%%%%%%%%%%%%%%.%%%%.%%%%%%%%%%%%%.%%%%.%
%.............................................%
%%%%%%%%%%%%%%%%%%%%%%%%%%%%%%%%%%%%%%%%%%%%%%%